+-------+     +-------+     +-------+
|.......|     |.......|     |.......|
|.......|     |.......#######.......|
|.......|     |.......|     |.......|
|.......+-----+.......|     |.......|
|.....................|     |.......|
|.....................|     |.......|
|.......+-----+.......|     |.......|
|.......|     |.......|     |.......|
|.......|     |.......#######.......|
|.......|     |.......|     |.......|
+-------+     +-------+     +-------+